1111111111111111111
1000000010000000001
1010101010101010101
1010100000001000101
1110101010101101101
1000001010101000001
1110101010100011101
1000101010101000001
1010101010101110111
1010000000000000111
1011111010101011101
1000000010100010101
1011111010111010101
1000000010000000001
1111111111111111111
