1111111111111111101
1000001000000010001
1110101010111010101
1010000010100000101
1010101110101110101
1000100000100000101
1011111110001110101
1000100000100010101
1110001111101010101
1000100000101000001
1011111110001111101
1000001000101000101
1111101011101010101
0000000010000010001
1111111111111111111